R  700 500
NO ./texturas/brick.xpm
SO ./texturas/jardim.xpm
WE ./texturas/blue.xpm
EA ./texturas/wall.xpm
S ./texturas/chalice.xpm
F 255,245,200
C 0,0,200

11111111111111111111111111111
10000000001100010000010000201
10110000011100000000020010001
10100002000000100000000010001
10110020000100000000000010001
10000000000100000111011110001
10000000000000000100000011111
11110111111111011101010000001
11010100110101011000000011111
10000000200000000000000000001
10000000000000001101010010001
10000000000000W00211010100101
12000000000000001101010010001
10000000000000001101010010001
11000000200101000000010010001
10000000100101011111010010001
11111111111111111111111111111
