R  800 700
NO ./texturas/muro4.xpm
SO ./texturas/jardim.xpm
WE ./texturas/muro3.xpm
EA ./texturas/muro6.xpm
S ./texturas/lord3.xpm
F 255,211,211
C 0,0,200

11111111  1111111111111111
10000001111000001000000001
10000000000000001020000001
1000000111100E00000002000111111111
11111111  100000100000000000000001
          100000100002000100000001
          111111111111111111111111
