R 840 700
WE ./texturas/blue.xpm
NO ./texturas/brick.xpm
SO ./texturas/banner.xpm
EA ./texturas/wood.xpm
S ./texturas/lord3.xpm
C 225,200,200
F 5,0,200


  11111111  1111111111111111
  10000001111000001000000001
  10000000000000001000000001
  1000000111100000100000000111111111
  11111111  100000100000000000000001
            100000100000000100000001
111111111111100011111110000100000001
100000000000000000000000000111111001
100000010002000000200000000000001001
100000010000100000000000000000001001
100000010000111100111100000000001001
1000111111111  1001  100000000000001
10001          1001  111111011111111
10001          1001       101
10001111111111110011111111101111111
10001000000000000000000000000000001
100000200000000020000000020000000N1
11111111111111111111111111111111111
